
                   MAGELLAN'S MAP SUBMISSION

Map Name:	[Cursed Vengence  (cursed~1.h3m)]
Map Maker:	[Lord Sparky]
E-Mail Address:	[knorman2@home.com]

Map Size:       [Medium] [1 level]

Map Type:	[Multiplayer] [4 Humans Or Computer]
Language:	[English]

Description:	[For years your land has been growing stale.  Evil magics currupt all vegetation.  Can you find out why the land grows more stale every day?]

Special Win:	[NONE]
Special Loss:	[NONE]
Special Other:	[NONE]

Narrative:	[Creator: Ken Norman feat. Marin Bouman - special thanks to marin for the awesome brushing work done]

Play-Testers:	[Craig Hawkins at CraigHack@art-of-war.net]
  




            	
SPOILERS:	WARNING!!!  SPOILER INFORMATION FOLLOWS PROCEED AT YOUR OWN RISK!
SPOILERS:	WARNING!!!  SPOILER INFORMATION FOLLOWS PROCEED AT YOUR OWN RISK!
SPOILERS:	WARNING!!!  SPOILER INFORMATION FOLLOWS PROCEED AT YOUR OWN RISK!
SPOILERS:	WARNING!!!  SPOILER INFORMATION FOLLOWS PROCEED AT YOUR OWN RISK!


Put tips, strategies or other spoilers here if you have any.

magic in ALMOST useless..  choose your hero carefully..
==================================================================================

